SETTINGS_PAGE_GENERAL_HEADER_LANG	Lingua
SETTINGS_PAGE_GENERAL_HEADER_GIZMO	Gizmo
SETTINGS_PAGE_GENERAL_HEADER_SELECTION	Selezione
SETTINGS_PAGE_GENERAL_HEADER_DEBUG	Debug
SETTINGS_PAGE_GENERAL_HEADER_SCREENSHOT	Screenshot

SETTINGS_PAGE_GENERAL_GIZMOSIZE	Moltiplicatore Dimensione
SETTINGS_PAGE_GENERAL_OUTLINEWIDTH	Larghezza Contorno
SETTINGS_PAGE_GENERAL_OUTLINECOLOR	Colore Contorno
SETTINGS_PAGE_GENERAL_TOGGLEPERFPANEL	Pannello Performance
SETTINGS_PAGE_GENERAL_TOGGLEDATAOBJCOMPRESSION	Compressione Dataobject 

SETTINGS_PAGE_GENERAL_SS_FORMAT	Formato Data
SETTINGS_PAGE_GENERAL_SS_ALPHA	Trasparenza
SETTINGS_PAGE_GENERAL_SS_UPSCALE	Upscaling

SETTINGS_PAGE_GENERAL_SS_NONE	Nessun Upscaling
SETTINGS_PAGE_GENERAL_SS_TWO	2x Upscaling
SETTINGS_PAGE_GENERAL_SS_FOUR	4x Upscaling
SETTINGS_PAGE_GENERAL_SS_EIGHT	8x Upscaling
SETTINGS_PAGE_GENERAL_HEADER_UI	 Interfaccia
SETTINGS_PAGE_GENERAL_UI_ANIMATIONSPEED	Velocit√† animazioni interfaccia	-2
SETTINGS_PAGE_GENERAL_SCREENPOSITION_TOPLEFT	In Alto a Sinistra
SETTINGS_PAGE_GENERAL_SCREENPOSITION_TOPCENTER	In Alto al Centro
SETTINGS_PAGE_GENERAL_SCREENPOSITION_TOPRIGHT	In Alto a Destra
SETTINGS_PAGE_GENERAL_SCREENPOSITION_MIDDLELEFT	Al Centro a Sinistra
SETTINGS_PAGE_GENERAL_SCREENPOSITION_MIDDLECENTER	Al Centro
SETTINGS_PAGE_GENERAL_SCREENPOSITION_MIDDLERIGHT	Al Centro a Destra
SETTINGS_PAGE_GENERAL_SCREENPOSITION_BOTTOMLEFT	In Basso a Sinstra
SETTINGS_PAGE_GENERAL_SCREENPOSITION_BOTTOMCENTER	In Basso al Centro
SETTINGS_PAGE_GENERAL_SCREENPOSITION_BOTTOMRIGHT	In Basso a Destra
SETTINGS_PAGE_GENERAL_DEVMODE	Toggle Developer Mode
SETTINGS_PAGE_GENERAL_ALLOWSCRIPTEDMODS	Allow Mods with Custom Code (Restart required, potentially dangerous)
